R   1920   1080
EA ./path_to_the_east_texture
NO ./path_to_the_north_texture
WE ./path_to_the_west_texture
SO ./path_to_the_south_texture
S  ./path_to_the_sprite_texture
F 220   ,    255  ,    0    
C 2,3,0

111111111111111111111111
10001000000100000000000111111111111
11011111011110111111000000000000001
11000000000000000021111000000000001
1110000002W000000011111100000000001
11101111111111110111100000000000001
11101111111111110000000000000000001
11100000000000000111100000000000001
11111111111111111111111111111111111
 
1   1 111 111     111  1 
11 11 1 1 1 1  1  1 1 11
1 1 1 111 111     1 1  1
1   1 1 1 1    1  111  1