R   1920   1080
EA ./path_to_the_east_texture
NO ./path_to_the_north_texture
WE ./path_to_the_west_texture
SO ./path_to_the_south_texture
S  ./path_to_the_sprite_texture
F  220   ,    255  ,    0    
C  225,30,0

1111111111111111111111111111111111   11111111111111111111111111111111111111
111111111111111111111111111111111111111111111111111111111111111111111111
11111111111111111111111111111111111111111111111111111111111111111111111
111111111111111111111111111111111111111111111111111111111111111111111111
111111111111111111111111111111111111111111111111111111111111111111111111
111111111111111111111111111111111111111111111111111111111111111111111111
111111111111111111111111111111111111111111111111111111111111111111111111
111111111111111111111111111111111111111111111111111111111111111111111111
111111111111111111111111111111111111111111111111111111111111111111111111
111111111111111111111111111111111111111111111111111111111111111111111111
111111111111111111111111111111111111111111111111111111111111111111111111
111111111111111111111111111111111111111111111111111111111111111111111111
111111111111111111111111111111111111111111111111111111111111111111111111
111111111111111111111111111111111111111111111111111111111111111111111111
111111111111111111111111111111111111111111111111111111111111111111111111
111111111111111111111111111111111111111111111111111111111111111111111111
111111111111111111111111111111111111111111111111111111111111111111111111
111111111111111111111111111111111111111111111111111111111111111111111111
111111111111111111111111111111111111111111111111111111111111111111111111
111111111111111111111111111111111111111111111111111111111111111111111111
111111111111111111111111111111111111111111111111111111111111111111111111
111111111111111111111111111111111111111111111111111111111111111111111111
111111111111111111111111111111111111111111111111111111111111111111111111
111111111111111111111111111111111111111111111111111111111111111111111111
111111111111111111111111111111111111111111111111111111111111111111111111
111111111111111111111111111111111111111111111111111111111111111111111111
111111111111111111111111000000000000000000000000111111111111111111111111
111111111111111111111111000000000000000000000000111111111111111111111111
111111111111111111111111000000000000000000000000111111111111111111111111
111111111111111111111111000000000000000000000000111111111111111111111111
11111111111111111111111100000000000000000000000011111111111111111111111111111111111111111111111111111
11111111111111111111111100000000000W000000000000111111111111111111111111111111111111111111111111111111
111111111111111111111111000000000000000000000000111111111111111111111111
11111111111111111111111100000000000000000000000111111111111111111111111
111111111111111111111111000000000000000000000000111111111111111111111111
111112111111111111111111000000000000000000000000111111111111111111111111
111111111111111111111111000000000000000000000222111111111111111111111111
11111111111111111111111111111111111111111111111111111111111111111111111