R        1024     720 
EA ./path_to_the_east_texture
NO ./path_to_the_north_texture
WE ./path_to_the_west_texture


SO ./path_to_the_south_texture
S  ./path_to_the_sprite_texture
F 220,255,0
C 225,30,0








        11111111111111111111
        1000000000111111
111111111000000200000111
1001000000000000000000011
111111111011000001110001
1000000000110000011101111
111101111111110111000111




1111011111111101110101
1100000011010101110001
1000200000000000110011111
100000S010000000110111
11000001110101011111111111
11110111 1110101 111111111
11111111 1111111 111111111









