R   1920   1080
EA ./path_to_the_east_texture
NO ./path_to_the_north_texture
WE ./path_to_the_west_texture
SO ./path_to_the_south_texture
S  ./path_to_the_sprite_texture
F  220   ,    255  ,    0    
C 2,3,0

111111111111
10W010000001
11011111011111111111
11000000000000000001111                                                     
1110000002000000001111111111111111111111111111111111111111111111111111111111
111011111111111111111                                                       
11101111111111111111
111111
11
11
11
1
1
1
1
1
1