R   5000   5000
EA ./texture/purplestone.xpm
NO ./texture/bluestone.xpm
WE ./texture/colorstone.xpm
SO ./texture/redbrick.xpm
S  ./sprite/barrel.xpm
F 0,0,100    
C 47,79,79


111111111111111111111111
100000000000000000000001
100200000100000000000001
100000020000222000000021
100000001000222000000021
100000022200000000W00021
100000200000000010000021
100000000000020000000001
100000000000000000000001
111111111111111111111111