R        1024     720 
EA ./path_to_the_east_texture
NO ./path_to_the_north_texture
WE ./path_to_the_west_texture


SO ./path_to_the_south_texture
S  ./path_to_the_sprite_texture
F 220,255,0
C 225,30,0
        11111111111111111111
        1000000000110000000
1011000001110000002000001
1001000000000000000000001
111111111011000001110000000
1000000000110000011101111
11110111111111011100000010001
11110111111111011101010
11000000110101011100000010001
1000200000000000110000001000
10000000000000001101010010
11000001110101011111011110
11110111 1110101 1011110100
11111111 1111111 1111111111