R   1280   720
EA ./texture/purplestone.xpm
NO ./texture/bluestone.xpm
WE ./texture/colorstone.xpm
SO ./texture/redbrick.xpm
S  ./path_to_the_sprite_texture
F 0,0,100    
C 47,79,79


111111111111111111111111111111
100010000000000000000000000001111111111111111111111111
110111110111101111110000000000000000000000000000000001
11000000001000000021111000000001001111111111111111110111111111
11100000000000011000111000010000001111111111111000000000000101
111011011111111100011000000000W0000000000000000000000000000101
11101101101111110000000010000000001111101111111100000000000001
11100000000000000111100000000020101111101      111111111111101
11111111111111111111111111111111111   101111111111111111111101
                                      100000000000000000000001
                                      111111111111111111111111